....................................
....................................
...##############################...
...#...................#........#...
...#.....@.............#........#...
...#..........########..........#...
...#............................#...
...#............................#...
...#.......################.....#...
...#.......#....................#...
...#.......#....................#...
...#.......#......0......#......#...
...#.......#.............#......#...
...#.......###############......#...
...#............................#...
...#............................#...
...#............................#...
...#............................#...
...#............................#...
...##############################...
....................................
....................................